3,2,8,0
10,2,8,1
20,2,8,2
10,2,4,1
3,2,2,0
20,2,2,2
5,2,10,1
15,2,10,0
10,2,1,0
20,2,7,1
15,2,7,2
10,2,4,1
15,2,8,1
10,2,8,2
20,2,2,0
30,2,2,1
20,2,10,0