15,2,0,0
10,2,0,2
5,2,1,0
10,2,9,0
10,2,9,2
10,2,3,1
15,2,5,1
10,2,5,2
5,2,0,0
0,2,0,1
10,2,1,0
0,2,9,1
0,2,9,2
10,2,3,2
0,2,3,1